########################################
########################################
########################################
####.........................%%%%%%#####
####...###########...........$$$$$$#####
####...#$$#######............$$$$$$#####
###%%$$%%%%%@%%%%%.....$$....$$$$$$#####
###############..#.....$.....$$$$$$#####
###.........####.#.....$$....%%%%%%#####
####...##........#.................#####
####..###..#.#.###.................#####
####...#####.#.###.................#####
#####..####..#..##....##$$##.......#####
####...#####.#.###....#%%%%#.......#####
#############..###.....#%%#........#####
############.?..##.................#####
##################.................#####
##################%%%%%%%%%%%%%%%%%#####
##################%%%%%%%%%%%%%%%%%#####
########################################
########################################
########################################

