########################################
########################################
########################################
####?%%%%%%%%%%%%%%######....%%%%%%#####
####%%%#########.............#$$$$$#####
####%%%#$$#######............###########
###%%$%%%%%%%%%%%%.....$$....$$$$$$#####
#####..########..#%%%%%%%%%%%$$$$$$#####
###.........####.#%%%%%%%%%%%%%%%%%#####
####...##........#%%%%%%%%%%%%%%%%%#####
####..###..#.#.###%%%%%%%%%%%%%%%%%#####
####..#########################....#####
#####..####..#.....................#####
####...#####.#.########...#######..#####
##.....#####$..#########..........@#####
####...#####...##########.#######..#####
####..%%%%%%...$$$$$$$$$$..........#####
##################%%%%%%%%%%%%%%%%%#####
##################%%%%%%%%%%%%%%%%%#####
########################################
########################################
########################################