##################################################################################
##################################################################################
##################################################################################
###########................................................................#######
###########.#############.####################.########################....#######
######?%%%%%%%%%%%%%%######....%%%%%%########..###########################.#######
######%%%#########.............#$$$$$######..........############.....####.#######
######%%%#$$#######............############....#.....##############..#####.#######
#####%%$%%%%%%%%%%%%.....$$....$$$$$$######..#####...#############.........#######
#######..########..#%%%%%%%%%%%$$$$$$######..$$$$$...#######.......#######.#######
#####.........####.#%%%%%%%%%%%%%%%%%######..........#######.#############.#######
######...##........#%%%%%%%%%%%%%%%%%#######################.#############.#######
######..###..#.#.###%%%%%%%%%%%%%%%%%#########..############.#############.#######
######..#########################...................########.#############.#######
#######..####..#...............#.....############............#############.#######
######...#####.#.########...#######..##########......#####################.#######
####.....#####$..#########...........#####@......#########################.#######
######...#####...##########.#######..#####..###########.##################.#######
######..%%%%%%...$$$$$$$$$$..........##################.##################.#######
###############.####%%%%%%%%%%%%%%%%%########%%%%%%%%%%%##################.#######
###%%%#########.####%%%%%%%%%%%%%%%%%########%######....##################.#######
####%%%%%%#####.###########..################%%%%%%%%%%%%%%%%%%%%%%%######.#######
###%%##%%%#####.##################################################%%######.#######
###%%%##%%#####.%%%%%%%%%%%%%%%%%%%%%%%%%%%%%%%%%%%%%%%%%%%%%%%%%%%%######.#######
###%%##########.#################%%%%%%%%#################################.#######
###.........###.#################%%%%%%%%#################################.#######
#######.#######.#################%%%%%%%%######################....#####...#######
#######.....................................................................######
##############$$$$$$$$%%%%%%%%%%%%%%%%%%%%%%%%%%%%%%%%%%%#######.....#############
##################################################################################
##################################################################################
##################################################################################