################################################################################
#########................................................................#######
#########.#############.####################.########################....#######
####?%%%%%%%%%%%%%%######....%%%%%%########..###########################.#######
####%%%#########.............#$$$$$######..........############.....####.#######
####%%%#$$#######............############....#.....##############..#####.#######
###%%$%%%%%%%%%%%%.....$$....$$$$$$######..#####...#############.........#######
#####..########..#%%%%%%%%%%%$$$$$$######..$$$$$...#######.......#######.#######
###.........####.#%%%%%%%%%%%%%%%%%######..........#######.#############.#######
####..%%%%%%...$$$$$$$$$$..........##################.##################.#######
#############.####%%%%%%%%%%%%%%%%%########%%%%%%%%%%%##################.#######
###%%%#########.####%%%%%%%%%%%%%%%%%########%######....################.#######
##%%%%%%#####.###########..################%%%%%%%%%%%%%%%%%%%%%%%######.#######
###%%##%%%#####.##################################################%%####.#######
###%%%##%%#####.%%%%%%%%%%%%%%%%%%%%%%%%%%%%%%%%%%%%%%%%%%%%%%%%%%%%####.#######
###%%##########.#################%%%%%%%%###############################.#######
###.........###.#################%%%%%%%%###############################.#######
#######.#######.#################%%%%%%%%######################....#####...#####
#####...................................@.................................######
############$$$$$$$$%%%%%%%%%%%%%%%%%%%%%%%%%%%%%%%%%%%#######.....#############
################################################################################
################################################################################
################################################################################
################################################################################