#####################################################################
#####################################################################
#####################################################################
##?........#%%%%%%%#....########.............#..#######...........###
##..........%%%%%%%#.$$$$$..............###..#.....####.#.###.....###
##.........#%%%%%%%#.##...$$$..##.....#####.....#....##.######$...###
####..########...#################..################..###########.####
##.........#%%%%%%%#%%%%%%%%#%%%%%%%%%%%%%%%#%%%%%%%%%%%%%#%......###
##..........%%%%%%%#%%%#%%%%.%%%%%%%%%%%%%%%#%%%%%%%%%%%%%#...@...###
###.........#%%%%%%%%%%%#%%%#%%%%%%%%%%%%%%%%#%%%%%%%%%%%%%#......###
######..##############################..#####################..######
##.........#......$$$.........#..............#.........$$#%%%%%%%$###
##.$$$$.......................#...#######......####....$$#%%%%%%%.###
##.........#.$$$..............#..............#.........$$........####
####.#############..########.######.#################.########....###
##.........#%%%%%%%%%%#%%%%%%%%%%%%%%#............................###
##..$$$....#%%%%%%%%%%#%%%%%%%%%%%%%%#........%%%%......$$$....#%.###
##.........#%%%%%%%%%%#%%%%%%%%%%%%%%#........%%%%......$$$$...#$$###
#####################################################################
#####################################################################
#####################################################################